#-#-#-#-#-#-#-#-
----------------
-#-#-#-#-#-#-#-#
----------------
#-#-#-#-#-#-#-#-
----------------
-#-#-#-#-#-#-#-#
----------------
#-#-#-#-#-#-#-#-
----------------
-#-#-#-#-#-#-#-#
----------------
#-#-#-#-#-#-#-#-
----------------
-#-#-#-#-#-#-#-#
----------------
