-#--#-##
--#-#---
---##-#-
-#-##-#-
-#--##--
--#--#--
--#-#--#
-#--##--
--#---#-
#--##-#-
-----#--
-###-#--
-######-
-####---
--#--#--
#---###-
###-----
