########################
#------#--------#------#
#-####-#-######-#-####-#
#----------------------#
####-#-###-##-###-#-####
---#-#-###-##-###-#-#---
####-#-----##-----#-####
#----####-####-####----#
####----------------####
---#-###-######-###-#---
---#-#---#----#---#-#---
---#-#-#-#----#-#-#-#---
####-#-#-######-#-#-####
#------#--------#------#
####-#####-##-#####-####
---#-------##-------#---
####-###-######-###-####
#----------------------#
#-####-###-##-###-####-#
#-####-#---##---#-####-#
#-####-#-######-#-####-#
#----------------------#
########################
