-#-#------
-###---##-
-#------#-
-#--------
-#-######-
-#--------
-########-
-#--------
-########-
----------