--##-##--
-#-----#-
-###-###-
---#-#---
#-------#
---#-#---
-###-###-
-#-----#-
--##-##--
